dimx : 41
dimy : 21
nb_caisses : 4
----------------------------------------
----------------------------------------
----------------------------------------
----------------------------------------
----------------------------------------
----------------------------------------
----------------------------------------
------------------####------------------
----------------###..##-----------------
----------------#P.0X.#-----------------
----------------#.0XA.#-----------------
----------------#.X0..#-----------------
----------------##..###-----------------
-----------------#..#-------------------
-----------------####-------------------
----------------------------------------
----------------------------------------
----------------------------------------
----------------------------------------
----------------------------------------
----------------------------------------
