dimx : 41
dimy : 21
nb_caisses : 15
----------------------------------------
----------------------------------------
----------------------------------------
----------------------------------------
----------------------------------------
----------------------------------------
----------------------------------------
----------------------------------------
--------------################----------
--------------#..............#----------
--------------#.#.######.....#----------
--------------#.#..X.X.X.X#..#----------
--------------#.#...XPX...##.##---------
--------------#.#..X.X.X###000#---------
--------------#.#...X.X..##000#---------
--------------#.###XXX.X.##000#---------
--------------#.....#.##.##000#---------
--------------#####...##.##000#---------
------------------#####.....###---------
----------------------#.....#-----------
----------------------#######-----------
