dimx : 41
dimy : 21
nb_caisses : 4
----------------------------------------
----------------------------------------
----------------------------------------
----------------------------------------
----------------------------------------
----------------------------------------
----------------------------------------
----------------------------------------
----------------------------------------
----------------------------------------
----------------------------------------
--------------------####----------------
--------------------#..#----------------
-------------------##X.#----------------
-----------------###00.#----------------
-----------------#.X00.#----------------
-----------------#.X#.P#----------------
-----------------#.X...#----------------
-----------------#...###----------------
-----------------#####------------------
----------------------------------------
