dimx : 41
dimy : 21
nb_caisses : 10
----------------------------------------
----------------------------------------
----------------------------------------
----------------------------------------
----------------------------------------
----------------------------------------
----------------------------------------
----------------------------------------
--------------############--------------
--------------#00..#.....###------------
--------------#00..#.X..X..#------------
--------------#00..#X####..#------------
--------------#00....P.##..#------------
--------------#00..#.#..X.##------------
--------------######.##X.X.#------------
----------------#.X..X.X.X.#------------
----------------#....#.....#------------
----------------############------------
----------------------------------------
----------------------------------------
----------------------------------------
