dimx : 41
dimy : 21
nb_caisses : 12
----------------------------------------
----------------------------------------
----------------------------------------
----------------------------------------
----------------------------------------
--------------------#####---------------
--------------------#...#####-----------
--------------------#.#X##..#-----------
--------------------#.....X.#-----------
------------#########.###...#-----------
------------#0000..##.X..X###-----------
------------#0000....X.XX.##------------
------------#0000..##X..X.P#------------
------------#########..X..##------------
--------------------#.X.X..#------------
--------------------###.##.#------------
----------------------#....#------------
----------------------######------------
----------------------------------------
----------------------------------------
----------------------------------------
