dimx : 41
dimy : 21
nb_caisses : 6
----------------------------------------
----------------------------------------
----------------------------------------
----------------------------------------
----------------------------------------
----------------------------------------
----------------#######-----------------
----------------#..#..#-----------------
----------------#.X.X.#-----------------
----------------#.0X0.#-----------------
----------------##000##-----------------
----------------#.XXX.#-----------------
----------------#..P..#-----------------
----------------#######-----------------
----------------------------------------
----------------------------------------
----------------------------------------
----------------------------------------
----------------------------------------
----------------------------------------
----------------------------------------
