dimx : 41
dimy : 21
nb_caisses : 5
----------------------------------------
----------------------------------------
----------------------------------------
----------------------------------------
----------------------------------------
----------------------------------------
----------------------------------------
---------------####---------------------
---------------#..###-------------------
---------------#.XX.#-------------------
---------------#..#.##------------------
--------------###.X..#------------------
--------------#...#X.#------------------
--------------#.#X0P0#------------------
--------------#...000#------------------
--------------#......#------------------
--------------########------------------
----------------------------------------
----------------------------------------
----------------------------------------
----------------------------------------
