dimx : 41
dimy : 21
nb_caisses : 14
----------------------------------------
----------------------------------------
----------------------------------------
----------------------------------------
----------------------------------------
---------------------#######------------
---------------------#..000#------------
-----------------#####..000#------------
-----------------#......000#------------
-----------------#..##..000#------------
-----------------##.##..000#------------
----------------###.########------------
----------------#.XXX.##----------------
------------#####..X.X.#####------------
----------###...#X.X...#...#------------
----------#P.X...X....X..X.#------------
----------#######.XX.X.#####------------
----------------#......#----------------
----------------########----------------
----------------------------------------
----------------------------------------
