dimx : 41
dimy : 21
nb_caisses : 15
----------------------------------------
----------------------------------------
----------------------------------------
----------------------------------------
----------------------------------------
----------------------------------------
--------------#########-----------------
-------------##...##..######------------
-----------###.....#..#....###----------
-----------#..X.#X.#..#..000.#----------
-----------#.#.X#PX##.#.#0#0.#----------
-----------#..#.#X..#....0.0.#----------
-----------#.X......#.#.#0#0.#----------
-----------#...##..##X.X.0.0.#----------
-----------#.X.#...#..#X#0#0.#----------
-----------##.X..X...X..X000.#----------
------------#X.######....##..#----------
------------#..#----##########----------
------------####------------------------
----------------------------------------
----------------------------------------
