dimx : 41
dimy : 21
nb_caisses : 8
----------------------------------------
----------------------------------------
----------------------------------------
----------------------------------------
----------------------------------------
----------------------------------------
----------------------------------------
--------------########------------------
--------------#00....#------------------
--------------#00X.XP#------------------
--------------#X#XXX##------------------
--------------#00X.X.#------------------
--------------#00....#------------------
--------------########------------------
----------------------------------------
----------------------------------------
----------------------------------------
----------------------------------------
----------------------------------------
----------------------------------------
----------------------------------------
