dimx : 41
dimy : 21
nb_caisses : 4
----------------------------------------
----------------------------------------
----------------------------------------
----------------------------------------
----------------------------------------
----------------------------------------
----------------------------------------
------------------####------------------
----------------###..#------------------
--------------###0.X.#------------------
--------------#00X.X.#------------------
--------------#0..X#P#------------------
--------------###....#------------------
----------------###..#------------------
------------------####------------------
----------------------------------------
----------------------------------------
----------------------------------------
----------------------------------------
----------------------------------------
----------------------------------------
