dimx : 41
dimy : 21
nb_caisses : 3
----------------------------------------
----------------------------------------
----------------------------------------
----------------------------------------
----------------------------------------
----------------------------------------
-----------------#####------------------
----------------##...#------------------
----------------#.X..##-----------------
----------------#.#XX.#-----------------
----------------#.#0#P#-----------------
----------------#.00..#-----------------
----------------###...#-----------------
------------------#####-----------------
----------------------------------------
----------------------------------------
----------------------------------------
----------------------------------------
----------------------------------------
----------------------------------------
----------------------------------------
