dimx : 41
dimy : 21
nb_caisses : 3
----------------------------------------
----------------------------------------
----------------------------------------
----------------------------------------
----------------------------------------
----------------------------------------
----------------------------------------
-----------------#####------------------
---------------###...#------------------
---------------#...#X#------------------
--------------##.##..#------------------
--------------#.X....#------------------
--------------#P.##X.#------------------
--------------####000#------------------
-----------------#####------------------
----------------------------------------
----------------------------------------
----------------------------------------
----------------------------------------
----------------------------------------
----------------------------------------
