dimx : 41
dimy : 21
nb_caisses : 4
----------------------------------------
----------------------------------------
----------------------------------------
----------------------------------------
----------------------------------------
----------------------------------------
----------------####--------------------
----------------#..####-----------------
---------------##.0.0.#-----------------
---------------#.X.X#.#-----------------
---------------#P#0X..#-----------------
---------------#..X.###-----------------
---------------###..#-------------------
-----------------####-------------------
----------------------------------------
----------------------------------------
----------------------------------------
----------------------------------------
----------------------------------------
----------------------------------------
----------------------------------------
