dimx : 41
dimy : 21
nb_caisses : 5
----------------------------------------
----------------------------------------
----------------------------------------
----------------------------------------
----------------------------------------
----------------------------------------
----------------------------------------
-----------------#####------------------
-----------------#.P.#####--------------
-----------------#.......#--------------
-----------------#.XAAAA0#--------------
-----------------#..#....#--------------
-----------------#########--------------
----------------------------------------
----------------------------------------
----------------------------------------
----------------------------------------
----------------------------------------
----------------------------------------
----------------------------------------
----------------------------------------
