dimx : 41
dimy : 21
nb_caisses : 5
----------------------------------------
----------------------------------------
----------------------------------------
----------------------------------------
----------------------------------------
----------------------------------------
----------------------------------------
----------------------------------------
----------------------------------------
----------------------------------------
----------------------------------------
---------------#####--------------------
---------------#...###------------------
---------------#.X00.#------------------
---------------#.X00.#------------------
---------------#.XX0##------------------
---------------###.X#-------------------
-----------------#P.#-------------------
-----------------####-------------------
----------------------------------------
----------------------------------------
