dimx : 41
dimy : 21
nb_caisses : 4
----------------------------------------
----------------------------------------
----------------------------------------
----------------------------------------
----------------------------------------
----------------------------------------
----------------------------------------
----------------------------------------
----------------------------------------
------------------#####-----------------
---------------####..0#-----------------
---------------#.X.X.0#-----------------
---------------#.PX.X0#-----------------
---------------##.##00#-----------------
----------------#######-----------------
----------------------------------------
----------------------------------------
----------------------------------------
----------------------------------------
----------------------------------------
----------------------------------------
