dimx : 41
dimy : 21
nb_caisses : 1
----------------------------------------
----------------------------------------
----------------------------------------
----------------------------------------
----------------------------------------
----------------------------------------
----------------------------------------
------------------#####-----------------
----------------###...#-----------------
----------------#.X...##----------------
----------------#.#..0.#----------------
----------------#....#.#----------------
----------------##.#...#----------------
-----------------#P..###----------------
-----------------#####------------------
----------------------------------------
----------------------------------------
----------------------------------------
----------------------------------------
----------------------------------------
----------------------------------------
