dimx : 41
dimy : 21
nb_caisses : 2
----------------------------------------
----------------------------------------
----------------------------------------
----------------------------------------
----------------------------------------
-----------------#####------------------
-----------------#...#------------------
----------------##X#.###----------------
----------------#...XP.#----------------
----------------#.#..#.#----------------
----------------#.#0.0.#----------------
----------------#...####----------------
----------------#####-------------------
----------------------------------------
----------------------------------------
----------------------------------------
----------------------------------------
----------------------------------------
----------------------------------------
----------------------------------------
----------------------------------------
