dimx : 41
dimy : 21
nb_caisses : 3
----------------------------------------
----------------------------------------
----------------------------------------
----------------------------------------
----------------------------------------
----------------------####--------------
----------------#######..#--------------
----------------#........#--------------
----------------#..X.#0#.#--------------
----------------#.XX##.#.##-------------
----------------###.0.P...#-------------
------------------###..#..#-------------
--------------------##0..##-------------
---------------------#####--------------
----------------------------------------
----------------------------------------
----------------------------------------
----------------------------------------
----------------------------------------
----------------------------------------
----------------------------------------
