dimx : 41
dimy : 21
nb_caisses : 2
----------------------------------------
----------------------------------------
----------------------------------------
----------------------------------------
----------------------------------------
----------------------------------------
---------------####---------------------
---------------#..####------------------
---------------#.....#------------------
---------------#.....#------------------
---------------###.###------------------
---------------#.XX..##-----------------
---------------#.0.0P.#-----------------
---------------####...#-----------------
------------------#####-----------------
----------------------------------------
----------------------------------------
----------------------------------------
----------------------------------------
----------------------------------------
----------------------------------------
