dimx : 41
dimy : 21
nb_caisses : 3
----------------------------------------
----------------------------------------
----------------------------------------
----------------------------------------
----------------------------------------
----------------------------------------
---------------#####--------------------
---------------#...##-------------------
--------------##0#X.##------------------
--------------#.X....#------------------
--------------#0.0#X.#------------------
--------------###.P.##------------------
----------------#.#.#-------------------
----------------#...#-------------------
----------------#####-------------------
----------------------------------------
----------------------------------------
----------------------------------------
----------------------------------------
----------------------------------------
----------------------------------------
