dimx : 41
dimy : 21
nb_caisses : 3
----------------------------------------
----------------------------------------
----------------------------------------
----------------------------------------
----------------------------------------
--------------#######-------------------
--------------#..#..##------------------
-------------##.AAX0.#------------------
-------------#...#...#------------------
-------------#...P.###------------------
-------------#..####--------------------
-------------####-----------------------
----------------------------------------
----------------------------------------
----------------------------------------
----------------------------------------
----------------------------------------
----------------------------------------
----------------------------------------
----------------------------------------
----------------------------------------
