dimx : 41
dimy : 21
nb_caisses : 3
----------------------------------------
----------------------------------------
----------------------------------------
----------------------------------------
----------------------------------------
----------------------------------------
-----------------#####------------------
----------------##...###----------------
----------------#.0.0.0#----------------
----------------#.#.##.##---------------
----------------#....XXP#---------------
----------------###.#.X.#---------------
------------------#...###---------------
------------------#####-----------------
----------------------------------------
----------------------------------------
----------------------------------------
----------------------------------------
----------------------------------------
----------------------------------------
----------------------------------------
