dimx : 41
dimy : 21
nb_caisses : 2
----------------------------------------
----------------------------------------
----------------------------------------
----------------------------------------
----------------------------------------
----------------------------------------
------------------####------------------
---------------####..#------------------
--------------##.X...#------------------
--------------#..#.#X#------------------
--------------#0P0...##-----------------
--------------##.#.#..#-----------------
---------------#......#-----------------
---------------#..#####-----------------
---------------####---------------------
----------------------------------------
----------------------------------------
----------------------------------------
----------------------------------------
----------------------------------------
----------------------------------------
