dimx : 41
dimy : 21
nb_caisses : 2
----------------------------------------
----------------------------------------
----------------------------------------
----------------------------------------
----------------------------------------
----------------------------------------
----------------------------------------
------------------####------------------
--------------#####..#------------------
--------------#...A..#------------------
--------------#.A0#..#------------------
--------------##.##.##------------------
--------------#.X....#------------------
--------------#.P#...#------------------
--------------#..#####------------------
--------------####----------------------
----------------------------------------
----------------------------------------
----------------------------------------
----------------------------------------
----------------------------------------
