dimx : 41
dimy : 21
nb_caisses : 3
----------------------------------------
----------------------------------------
----------------------------------------
----------------------------------------
----------------------------------------
-------------------####-----------------
----------------####..#-----------------
----------------#.X.X.#-----------------
----------------#..0#.##----------------
----------------##.#0..#----------------
----------------#.P..X.#----------------
----------------#0..####----------------
----------------#####-------------------
----------------------------------------
----------------------------------------
----------------------------------------
----------------------------------------
----------------------------------------
----------------------------------------
----------------------------------------
----------------------------------------
