dimx : 41
dimy : 21
nb_caisses : 3
----------------------------------------
----------------------------------------
----------------------------------------
----------------------------------------
----------------------------------------
----------------------------------------
------------------####------------------
---------------####..#------------------
--------------##.X...#------------------
--------------#..#.#X#------------------
--------------#0P00..##-----------------
--------------##.#.#..#-----------------
---------------#...X..#-----------------
---------------#..#####-----------------
---------------####---------------------
----------------------------------------
----------------------------------------
----------------------------------------
----------------------------------------
----------------------------------------
----------------------------------------
