dimx : 41
dimy : 21
nb_caisses : 3
----------------------------------------
----------------------------------------
----------------------------------------
----------------------------------------
----------------------------------------
----------------------------------------
----------------------------------------
----------------#####-------------------
--------------###...#-------------------
--------------#.X.#.##------------------
--------------#.#..0.#------------------
--------------#.0..#.#------------------
--------------##X#0X.#------------------
---------------#P..###------------------
---------------#####--------------------
----------------------------------------
----------------------------------------
----------------------------------------
----------------------------------------
----------------------------------------
----------------------------------------
