dimx : 41
dimy : 21
nb_caisses : 2
----------------------------------------
----------------------------------------
----------------------------------------
----------------------------------------
----------------------------------------
----------------------------------------
----------------#####-------------------
----------------#...###-----------------
----------------#.....#-----------------
----------------##....#-----------------
----------------####X##-----------------
----------------#..X.##-----------------
----------------#.P...#-----------------
----------------###0.0#-----------------
------------------#####-----------------
----------------------------------------
----------------------------------------
----------------------------------------
----------------------------------------
----------------------------------------
----------------------------------------
