dimx : 41
dimy : 21
nb_caisses : 2
----------------------------------------
----------------------------------------
----------------------------------------
----------------------------------------
----------------------------------------
----------------------------------------
-----------------#####------------------
----------------##...###----------------
----------------#.0.0..#----------------
----------------#.#.##.##---------------
----------------#....XXP#---------------
----------------###.#...#---------------
------------------#...###---------------
------------------#####-----------------
----------------------------------------
----------------------------------------
----------------------------------------
----------------------------------------
----------------------------------------
----------------------------------------
----------------------------------------
