dimx : 41
dimy : 21
nb_caisses : 1
----------------------------------------
----------------------------------------
----------------------------------------
----------------------------------------
----------------------------------------
----------------------------------------
----------------------------------------
------------------####------------------
--------------#####..#------------------
--------------#...X..#------------------
--------------#.A0#..#------------------
--------------##.##.##------------------
--------------#......#------------------
--------------#.P#...#------------------
--------------#..#####------------------
--------------####----------------------
----------------------------------------
----------------------------------------
----------------------------------------
----------------------------------------
----------------------------------------
