dimx : 41
dimy : 21
nb_caisses : 3
----------------------------------------
----------------------------------------
----------------------------------------
----------------------------------------
----------------------------------------
----------------------------------------
---------------#####--------------------
---------------#...##-------------------
---------------#.#..###-----------------
---------------#...AX.#-----------------
---------------###..#P#-----------------
-----------------#.A0.#-----------------
-----------------#..###-----------------
-----------------####-------------------
----------------------------------------
----------------------------------------
----------------------------------------
----------------------------------------
----------------------------------------
----------------------------------------
----------------------------------------
