dimx : 41
dimy : 21
nb_caisses : 2
----------------------------------------
----------------------------------------
----------------------------------------
----------------------------------------
----------------------------------------
----------------------------------------
----------------#####-------------------
----------------#...##------------------
----------------#....##-----------------
----------------#.0#X.#-----------------
----------------##.P..#-----------------
-----------------#0#X##-----------------
-----------------#...#------------------
-----------------#####------------------
----------------------------------------
----------------------------------------
----------------------------------------
----------------------------------------
----------------------------------------
----------------------------------------
----------------------------------------
