dimx : 41
dimy : 21
nb_caisses : 18
----------------------------------------
----------------------------------------
---------------#######------------------
---------------#..#..####---------------
-----------#####.X#X.#..##--------------
-----------#00.#..#..#...#--------------
-----------#00.#.X#X.#..X####-----------
-----------#00.#.....#X..#..#-----------
-----------#00...X#..#.X....#-----------
-----------#00P#..#X.#X..#..#-----------
-----------#00.#.X#.....X#..#-----------
-----------#00.#..#XX#X..#..##----------
-----------#00.#.X#..#..X#X..#----------
-----------#00.#..#..#...#...#----------
-----------##0.####..#####...#----------
------------####--####---#####----------
----------------------------------------
----------------------------------------
----------------------------------------
----------------------------------------
----------------------------------------
