dimx : 41
dimy : 21
nb_caisses : 20
----------------------------------------
----------------------------------------
----------------------------------------
----------------------------------------
------------#################-----------
------------#000...#....#...##----------
-----------##00000..X##.#.#X.#----------
-----------#000000#..X..#....#----------
-----------#000000#..#..#.#..#----------
-----------#########.X..X.X..#----------
-------------#.....#X##X.##X##----------
------------##...X....#.X....#----------
------------#..##.###.#..##X.#----------
------------#.X.XX.....X..X..#----------
------------#.X....X##X.######----------
------------#######..P.##---------------
------------------######----------------
----------------------------------------
----------------------------------------
----------------------------------------
----------------------------------------
