dimx : 41
dimy : 21
nb_caisses : 11
----------------------------------------
----------------------------------------
----------------------------------------
----------------------------------------
----------------------------------------
----------------------------------------
---------------------########-----------
---------------------#.....P#-----------
---------------------#.X#X.##-----------
---------------------#.X..X#------------
---------------------##X.X.#------------
-------------#########.X.#.##-----------
-------------#0000..##.X..X.#-----------
-------------##000....X..X..#-----------
-------------#0000..#########-----------
-------------########-------------------
----------------------------------------
----------------------------------------
----------------------------------------
----------------------------------------
----------------------------------------
