dimx : 41
dimy : 21
nb_caisses : 11
----------------------------------------
----------------------------------------
----------------------------------------
----------------------------------------
----------------------------------------
----------------------------------------
--------------------#####---------------
--------------#######...##--------------
-------------##.#.P##.XX.#--------------
-------------#....X......#--------------
-------------#..X..###...#--------------
-------------###.#####X###--------------
-------------#.X..###.00#---------------
-------------#.X.X.X.000#---------------
-------------#....###000#---------------
-------------#.XX.#-#000#---------------
-------------#..###-#####---------------
-------------####-----------------------
----------------------------------------
----------------------------------------
----------------------------------------
