dimx : 41
dimy : 21
nb_caisses : 6
----------------------------------------
----------------------------------------
---------------##########---------------
---------------#00..#...#---------------
---------------#00......#---------------
---------------#00..#..####-------------
--------------#######..#..##------------
--------------#............#------------
--------------#..#..##..#..#------------
------------####.##..####.##------------
------------#..X..#####.#..#------------
------------#.#.X..X..#.X..#------------
------------#.PX..X...#...##------------
------------####.##.#######-------------
---------------#....#-------------------
---------------######-------------------
----------------------------------------
----------------------------------------
----------------------------------------
----------------------------------------
----------------------------------------
