dimx : 41
dimy : 21
nb_caisses : 13
----------------------------------------
----------------------------------------
----------------------------------------
----------------------------------------
----------------------------------------
---------------#######------------------
---------------#--#--#####--------------
--------------##--#--#000###------------
--------------#--X#--#000--#------------
--------------#-X-#XX-000--#------------
--------------#--X#--#000-0#------------
--------------#---#-X########-----------
--------------##X-------X-X-#-----------
--------------##--#--XX-#---#-----------
---------------######--##XXP#-----------
--------------------#------##-----------
--------------------########------------
----------------------------------------
----------------------------------------
----------------------------------------
----------------------------------------
