dimx : 41
dimy : 21
nb_caisses : 20
----------------------------------------
----------------------------------------
----------------------------------------
----------------------------------------
------------------------########--------
------------------------#..0000#--------
-------------############..0000#--------
-------------#....#..X.X...0000#--------
-------------#.XXX#X..X.#..0000#--------
-------------#..X.....X.#..0000#--------
-------------#.XX.#X.X.X########--------
-------------#..X.#.....#---------------
-------------##.#########---------------
-------------#....#....##---------------
-------------#.....X...##---------------
-------------#..XX#XX..P#---------------
-------------#....#....##---------------
-------------###########----------------
----------------------------------------
----------------------------------------
----------------------------------------
