dimx : 41
dimy : 21
nb_caisses : 10
----------------------------------------
----------------------------------------
----------------------------------------
----------------------------------------
-----------------###########------------
-----------------#..0..#...#------------
-----------------#.#0....P.#------------
-------------#####.##00#.####-----------
------------##..#.00###.....###---------
------------#.X.#000...X.#....#---------
------------#....00.##..##.##.#---------
------------####X##X#.X.#...#.#---------
--------------##.#....#X.XX.#.#---------
--------------#..X.#.#..#.X##.#---------
--------------#...............#---------
--------------#..###########..#---------
--------------####---------####---------
----------------------------------------
----------------------------------------
----------------------------------------
----------------------------------------
