dimx : 41
dimy : 18
nb_caisses : 2
----------------------------------------
----------------------------------------
----------------------------------------
----------------------------------------
----------------------------------------
----------------------------------------
----------------------------------------
----------------####--------------------
--------------###..####-----------------
--------------#.....X.#-----------------
--------------#.#..#X.#-----------------
--------------#.00.#P.#-----------------
--------------#########-----------------
----------------------------------------
----------------------------------------
----------------------------------------
----------------------------------------
----------------------------------------