dimx : 41
dimy : 21
nb_caisses : 1
----------------------------------------
----------------------------------------
----------------------------------------
----------------------------------------
----------------------------------------
--------#####-####----------------------
--------#000#-#..####-------------------
--------#000###..X..#-------------------
--------#0000##.....###-----------------
--------##0000##......#-----------------
--------###000.##.....#-----------------
--------#.##....#.....#-----------------
--------#..##.#.###.####----------------
--------#...#P#........#----------------
--------#..............#----------------
--------#...#........###----------------
--------#..######..###------------------
--------#.##----####--------------------
--------###-----------------------------
----------------------------------------
----------------------------------------
