dimx : 41
dimy : 17
nb_caisses : 1
----------------------------------------
----------------------------------------
----------------------------------------
----------------------------------------
----------------------------------------
-------------#####----------------------
-------------#.S.#----------------------
-------------#...#----------------------
-----------###...##---------------------
-----------#......#---------------------
---------###.#.##.#---##E###------------
---------#...#.##.#####..00#------------
---------#.X.............00#------------
---------#####.###.#P##..00#------------
-------------#.....#########------------
-------------#######--------------------
----------------------------------------
