dimx : 41
dimy : 21
nb_caisses : 10
----------------------------------------
----------------------------------------
----------------------------------------
----------------------------------------
----------------------------------------
----------------------------------------
----------------------------------------
--------------######--###---------------
--------------#00..#-##.##--------------
--------------#A0..###...#--------------
--------------#A0........#--------------
--------------#A0..#.#X..#--------------
--------------#A0###.#...#--------------
--------------####.X.#XP.#--------------
-----------------#..X#...#--------------
-----------------#.X..X..#--------------
-----------------#..##...#--------------
-----------------#########--------------
----------------------------------------
----------------------------------------
----------------------------------------
