dimx : 41
dimy : 21
nb_caisses : 6
----------------------------------------
----------------------------------------
----------------------------------------
----------------------------------------
----------------------------------------
----------------------------------------
--------------#####---------------------
--------------#---#---------------------
--------------#X--#---------------------
------------###--X##--------------------
------------#--X-X-#--------------------
----------###-#-##-#---######-----------
----------#---#-##-#####--00#-----------
----------#-X--X----------00#-----------
----------#####-###-#P##--00#-----------
--------------#-----#########-----------
--------------#######-------------------
----------------------------------------
----------------------------------------
----------------------------------------
----------------------------------------
