dimx : 41
dimy : 21
nb_caisses : 6
----------------------------------------
----------------------------------------
----------------------------------------
----------------------------------------
----------------------------------------
----------------------------------------
----------------------------------------
----------------#######-----------------
----------------#0.0X.#-----------------
--------------####X#..#-----------------
--------------#PX0.0..#-----------------
--------------#.X#X#..#-----------------
--------------#.X0.A..#-----------------
--------------####0..##-----------------
-----------------#####------------------
----------------------------------------
----------------------------------------
----------------------------------------
----------------------------------------
----------------------------------------
----------------------------------------
