dimx : 41
dimy : 21
nb_caisses : 10
----------------------------------------
----------------------------------------
----------------------------------------
------------######----------------------
-----####--##....#----------------------
---###.S#--#..##.###--------------------
-###....####.#...X.#--########----------
-#..X...000.00..X..#--#.....P#----------
-#.X.X..##.###...###--#.X#..##----------
-###.###...#-#####----#.....#-----------
--#......###----------##..X.#-----------
--#...####---##########...#.###---------
--#####------#00....E##.XXX...#---------
-------------##0..............#---------
-------------#00.....##########---------
-------------#########------------------
----------------------------------------
----------------------------------------
----------------------------------------
----------------------------------------
----------------------------------------
