dimx : 41
dimy : 21
nb_caisses : 1
----------------------------------------
----------------------------------------
----------------------------------------
----------------------------------------
----------------------------------------
----------------------------------------
-------------#########------------------
-------------#.......#------------------
-------------#P......#------------------
-------------#.X..##.####---------------
-------------#...E##....#---------------
-------------######S....#---------------
------------------##....#---------------
-------------------#....#---------------
-------------------#...0#---------------
-------------------######---------------
----------------------------------------
----------------------------------------
----------------------------------------
----------------------------------------
----------------------------------------
