dimx : 41
dimy : 21
nb_caisses : 8
----------------------------------------
----------------------------------------
----------------------------------------
----------------------------------------
----------------------------------------
----------------------------------------
-----------####---####------------------
-----------#..#####..#------------------
-----------#....X..X.#------------------
-----------#.00X#.00.#------------------
-----------##.0.#X0X##------------------
------------#.0X#.0.#-------------------
------------##..#XX##-------------------
-------------#..#.P#--------------------
-------------#######--------------------
----------------------------------------
----------------------------------------
----------------------------------------
----------------------------------------
----------------------------------------
----------------------------------------
